index	country_code
Antigua and Barbuda	AG
Argentina	AR
Barbados	BB
Bolivia	BO
Brazil	BR
The Bahamas	BS
Belize	BZ
Chile	CL
Colombia	CO
Costa Rica	CR
Cuba	CU
Dominica	DM
Dominican Republic	DO
Ecuador	EC
Grenada	GD
Guatemala	GT
Guyana	GY
Honduras	HN
Haiti	HT
Jamaica	JM
Saint Kitts and Nevis	KN
Saint Lucia	LC
Mexico	MX
Nicaragua	NI
Panama	PA
Peru	PE
Paraguay	PY
Suriname	SR
El Salvador	SV
Trinidad and Tobago	TT
Uruguay	UY
Saint Vincent and the Grenadines	VC
Venezuela	VE
