loanword	integrated_verb	light_verb
access	accesar	hacer|tener acces
aim	aimear	hacer|tener aim
alert	alertear	hacer alert
audit	auditar	hacer (un) audit
ban	banear	hacer un ban
bang	bangear	hacer bang
bash	bashear	hacer|dar bash
block	blockear	hacer|dar (un) block
boycott	boicotear	hacer (un) boicot
box	boxear	hacer (el) box|boxing
bully	bulear	hacer|ser (el) bully
bust	bustear	hacer (el) bust
cast	castear	hacer cast|casting
change	changear	hacer change
chat	chatear	hacer chat
check	chequear	hacer un cheque
shoot	chutar	hacer|tomar el shot
combat	combatear	hacer (el) combat
connect	conectar	hacer (un) conexión
crack	crackear	hacer crack
customize	customizar	hacer custom|customized
default	defaultear	hacer default
delete	deletear	hacer|poner delete
DM	dmear	mandar|enviar|poner un dm
dope	dopar	hacer doping
downvote	downvotear	poner|dar (un) downvote
draft	draftear	hacer|tener draft
drain	drenar	hacer (el) dren
dribble	driblar	hacer (el) drible
encrypt	encriptar	hacer|ser encript
smash	esmachar	hacer smash
sniff	esnifar	hacer sniff
standard	estándar	hacer (un) standard
exit	exitear	hacer exit
export	exportear	hacer export
externalize	externalizar	hacer external
fangirl	fangirlear	hacer|ser fangirl
film	filmar	tomar (un) film
flash	flashear	hacer (un) flash
flex	flexear	hacer (un) flex
flip	flipar	hacer flip
flirt	flirtear	hacer flirt
focus	focalizar	hacer focus
format	formatear	hacer|dar (el) formato
form	formear	hacer form
freak	friquear	estar freaked
freeze	frizar	hacer freeze
fund	fundear	dar|hacer fund|funding
gentrify	gentrificar	hacer|tener gentrificación
ghost	gostear	hacer gost|ghost
google	googlear	buscar en google
hack	hackear	hacer hack
hail	hailear	hacer hail
hang	hanguear	hacer hang
harm	harmear	hacer harm
hypnosis	hipnotizar	hacer hipnosis
host	hostear	hacer host
hype	hypear	hacer hype
intercept	interceptear	hacer|tirar interception
hang	janguear	hacer hang (out)
lag	lagear	hacer (un) lag
like	likear	dar|poner (un) like
limit	limitear	hacer (un) limit
lynch	linchar	hacer lynch
link	linkear	dar|poner (un) link
love	lovear	hacer love
look	luquear	dar|hacer (un) look
make	makear	hacer make
melt	meltear	hacer melt
mope	mopear	hacer mope
nag	nagear	hacer nag
knock	noquear	dar|hacer (un) knockout
pack	packear	hacer pack
pan	panear	hacer|dar (un) panorama
panic	paniquear	tener panic
park	parquear	hacer parking
perform	performar	hacer (un) performance
pitch	pichear	hacer (un) pitch
pin	pinear	hacer pin
PM	pmear	enviar|mandar (un) pm
punch	ponchar	hacer un punch
post	postear	dar|poner (un) post
posterize	posterizar	hacer poster
print	printear	hacer print
protest	protestear	hacer (un) protest
push	puchar	hacer un push
pump	pumpear	hacer pump(s)
quote	quotear	hacer quote
rank	rankear	hacer rank
rant	rantear	hacer (un) rant
rape	rapear	hacer (un) rape
record	recordear	hacer (un) recording
remaster	remasterizar	hacer remastered
render	renderizar	hacer render(ed)
rent	rentear	hacer rental|renting
report	reportear	hacer (un) report
reset	resetear	hacer reset
respect	respectear	hacer respect
ring	ringear	hacer ring
rock	rockear	hacer rock
roll	rollear	hacer roll
sample	samplear	hacer (un) sample
selfie	selfiar	tomar (un) selfie
sext	sextear	dar|mandar un sext
ship	shippear	hacer ship
shitpost	shitpostear	hacer|poner un shitpost
shock	shockear	hacer shock
sign-in	signear	hacer sign-in
stalk	stalkear	actuar como un stalker
strike	strikear	hacer|dar un strike
surf	surfear	hacer surf
tackle	taclear	hacer tackle
text	textear	mandar|enviar un text
tick	ticar	hacer (un) tick
torment	tormentear	hacer torment
touch	touchear	hacer (un) touch
transport	transportear	hacer transport
travel	travelear	hacer travel
troll	trolear	actuar como un trol
tweet	tuitear	poner|enviar|hacer (un) tuit
twerk	twerkear	hacer twerk
upvote	upvotear	dar (un) upvote
vape	vapear	hacer|tomar vape|vaping
zap	zapear	hacer zap|zapping
